####...####
#...##....#
#.........#
...........
.#..@#.#...
...........
#....#....#
#.........#
##.#..#####
#.........#
####...####